10 15 4 2 3
5 1 2 3 10 3 11
7 12 1 7 14
2 14 2 6 9 6 12 3 10 3 11
0 0 0 1 1 1 1 1 2 2 1 1 1 1 0
0 0 0 1 9 1 1 0 0 0 0 0 2 1 0
0 0 0 1 1 1 0 0 0 0 0 0 2 1 7
0 0 0 0 0 0 0 2 1 1 1 1 1 1 1
0 0 1 0 0 0 0 2 2 0 0 0 0 0 1
0 7 1 2 0 0 0 2 2 0 0 0 0 0 1
2 2 2 2 0 0 0 1 1 0 0 0 0 1 1
2 2 2 1 2 1 2 2 1 2 0 0 6 1 0
1 2 2 2 2 2 2 2 2 2 2 2 1 0 0
0 2 1 2 2 2 0 0 2 2 2 2 1 0 0
