8 14 2 1 5
3 0 1 1 3
1 11 2 2 2 2 3
2 5 1 7 7
1 13 1 6 5 6 7
7 5 2 6 8 6 9
0 0 0 0 0 0 0 0 0 0 1 1 1 1
0 0 0 0 1 1 1 1 1 1 1 7 1 8
0 1 0 0 1 7 1 0 0 0 1 1 1 1
7 1 0 0 1 1 0 0 0 0 0 0 1 0
1 1 0 0 1 0 0 0 0 0 0 0 1 0
1 1 1 1 1 0 0 0 0 0 1 1 1 0
1 1 1 0 0 1 1 1 0 0 1 9 1 0
0 0 0 0 0 7 1 0 0 0 1 1 1 0
