9 14 5 10 3
1 7 2 3 2 3 3
0 13 1 3 12 5 10
7 1 2 4 3 7 9
0 0 0 0 0 1 1 1 1 0 0 0 0 8
0 0 0 0 0 1 1 5 1 1 1 0 0 1
0 0 0 0 1 1 1 1 1 1 1 0 0 1
1 1 1 1 1 1 1 1 0 0 1 1 1 1
1 1 1 0 0 0 1 0 0 0 1 1 0 0
1 1 1 0 0 0 1 0 0 0 1 0 0 0
0 1 0 0 0 0 1 1 1 0 0 0 0 0
0 7 0 0 0 0 1 9 1 0 0 0 0 0
0 0 0 0 0 0 1 1 1 0 0 0 0 0
