8 15 3 1 1
4 9 1 6 3
0 0 0 0 0 0 0 0 1 1 1 1 0 0 0
0 0 0 0 0 0 0 0 1 1 1 1 0 0 0
1 1 1 0 0 0 0 0 1 0 0 1 1 1 1
1 1 1 1 1 1 1 1 1 0 0 0 1 9 1
1 1 1 0 0 0 0 1 1 6 0 0 1 1 1
1 1 1 0 0 0 0 1 1 1 0 0 1 1 1
0 1 1 0 0 0 0 1 0 0 0 0 0 0 0
0 0 1 1 1 1 1 1 0 0 0 0 0 0 0
