10 15 3 1 13
2 5 2 7 3 7 4
7 6 2 7 3 7 4
0 7 2 7 3 7 4
4 7 2 7 3 7 4
2 8 2 7 3 7 4
3 9 2 7 3 7 4
3 10 2 7 3 7 4
4 10 2 7 3 7 4
5 11 2 7 3 7 4
6 11 2 7 3 7 4
3 13 2 7 3 7 4
7 13 2 7 3 7 4
7 14 1 1 11
0 0 0 0 0 1 1 5 1 1 1 0 0 0 0
0 0 0 0 0 1 1 1 1 1 1 0 0 0 0
1 1 1 0 0 5 1 1 5 1 1 1 1 1 0
1 1 1 1 1 1 1 1 1 5 5 1 1 5 0
0 0 0 0 0 1 1 5 1 1 5 1 1 1 0
0 0 0 0 0 1 1 1 1 1 1 5 1 1 0
1 1 1 0 0 1 1 1 1 1 1 5 1 1 1
1 9 1 1 1 1 5 1 0 0 1 1 1 5 7
1 1 1 0 0 1 1 1 0 0 0 1 1 1 1
1 1 1 0 0 0 0 0 0 0 0 0 1 1 1
