10 12 5 0 1
6 6 2 0 4 1 4
0 1 1 1 1 0 0 0 0 0 0 0
0 1 9 1 1 0 0 0 0 0 0 0
0 1 1 1 0 0 0 0 0 0 0 0
0 1 0 0 0 1 1 1 1 1 1 0
0 1 0 0 0 1 1 0 0 1 1 0
1 1 1 1 1 1 1 0 0 1 1 1
0 0 0 0 0 1 5 0 0 0 0 1
0 0 0 0 0 1 1 1 1 0 0 1
0 0 0 0 0 1 1 1 1 1 1 1
0 0 0 0 0 0 0 0 1 1 1 0
