10 15 1 1 5
8 1 1 7 8
6 12 1 2 7
9 12 2 7 8 1 9 7 8
3 12 0 6 6
3 13 1 6 6
1 1 1 0 0 0 0 0 0 0 0 0 0 0 0
1 1 1 1 1 1 1 1 1 0 0 0 1 1 1
1 1 1 0 0 0 0 0 1 1 1 1 1 9 1
1 1 1 0 0 0 0 0 0 0 0 0 7 7 1
1 1 1 0 0 0 0 0 0 0 0 0 0 0 0
1 1 1 0 0 0 0 0 0 0 0 0 0 0 0
1 1 1 0 0 0 0 1 1 1 1 1 7 0 0
1 1 1 1 1 1 1 1 0 0 0 1 1 0 0
1 3 1 0 0 0 0 0 0 0 0 1 1 0 0
1 1 1 0 0 0 0 0 0 0 0 1 7 0 0
