10 15 2 2 2
7 11 4 0 3 0 4 9 8 9 9
5 11 1 6 14 9 12
0 1 1 1 1 1 1 0 0 0 0 0 0 0 0
0 1 1 0 0 1 1 1 0 0 0 0 0 0 0
2 2 1 0 0 1 1 1 1 0 0 0 0 0 0
2 2 0 0 0 0 0 1 1 1 0 0 0 0 0
2 2 0 0 0 0 0 0 1 1 1 0 0 0 0
2 1 1 1 0 0 0 0 0 1 1 8 0 0 0
0 1 9 1 0 0 0 0 0 0 1 1 1 1 1
0 1 1 1 1 1 1 0 0 0 1 5 1 1 1
0 0 1 0 0 1 1 0 0 0 1 1 1 0 0
0 0 1 0 0 1 1 1 1 1 1 1 1 0 0
