10 15 1 13 4
1 8 2 1 6 1 5
3 3 2 8 5 8 6
5 6 2 8 5 8 6
6 14 2 8 5 8 6
0 0 0 0 0 0 0 0 0 0 0 1 1 1 1
0 1 1 1 1 1 1 1 3 1 1 1 1 1 1
0 1 1 1 1 0 0 0 0 0 0 0 1 1 1
0 1 1 4 1 0 0 0 0 0 0 0 0 0 0
0 1 1 1 1 0 0 0 0 0 0 0 0 0 0
0 0 0 1 1 1 5 1 1 1 1 1 1 0 0
0 0 0 0 0 0 0 0 0 0 1 1 1 1 3
1 1 1 0 0 0 0 0 0 0 1 1 1 1 1
1 9 1 1 1 1 1 1 1 1 1 1 1 0 0
1 1 1 1 0 0 0 0 0 0 0 0 0 0 0
