10 14 2 4 2
9 13 2 3 1 3 2
3 12 2 2 1 2 2
0 0 0 0 0 0 0 0 1 1 1 0 0 0
0 0 0 1 1 1 0 0 1 1 1 0 0 0
1 0 0 1 1 1 1 1 1 1 1 1 1 1
1 0 0 1 1 1 0 0 0 0 0 0 6 1
1 0 0 0 0 0 0 0 0 0 0 0 1 1
1 0 0 0 0 0 0 0 0 0 0 0 1 1
1 0 0 0 0 0 0 0 1 1 1 1 1 1
1 1 1 1 1 0 0 0 1 1 1 0 0 0
0 1 1 9 1 0 0 0 1 1 1 0 0 0
0 0 1 1 1 0 0 0 1 1 1 1 1 6
