10 14 7 1 3
6 2 2 4 8 4 9
8 8 2 6 4 6 5 3 7
2 4 4 4 8 4 9 2 13 3 13
0 0 1 1 0 0 0 0 0 0 0 0 0 0
0 0 1 1 1 0 0 0 0 0 0 0 0 0
0 0 1 1 3 0 0 0 0 0 1 1 1 0
0 0 0 1 1 1 1 0 0 0 1 9 1 0
0 0 0 0 0 0 1 1 0 0 1 1 1 0
0 1 1 0 0 0 1 1 0 0 0 0 0 0
1 1 7 1 1 1 1 1 0 0 0 0 0 0
1 1 1 0 0 0 1 1 0 0 0 1 1 1
1 1 1 0 0 0 1 1 5 1 1 1 1 1
0 0 0 0 0 0 0 0 0 0 0 1 1 1
