10 15 8 1 5
5 7 1 1 13 8 1
7 11 2 8 9 8 10
9 11 2 8 9 8 10
3 8 4 1 5 1 6 1 10 1 11
1 12 4 1 5 1 6 2 2 2 3
0 0 0 0 0 0 0 1 1 1 0 0 1 1 1
0 0 0 0 1 1 1 1 1 1 0 0 6 1 1
1 1 0 0 1 0 0 1 1 1 0 0 1 1 1
1 1 1 1 1 0 0 0 3 0 0 0 0 0 0
1 1 0 0 0 0 0 0 0 0 0 0 0 0 0
0 1 0 0 0 0 0 8 0 0 0 0 0 0 0
0 1 0 0 0 0 0 1 0 0 0 0 0 0 0
1 1 1 0 0 0 1 1 1 0 0 5 1 1 0
1 1 1 1 1 1 1 1 1 1 1 1 9 1 0
1 1 1 0 0 0 1 1 1 0 0 5 1 1 0
