10 15 7 12 5
7 7 8 2 4 2 5 2 9 2 10 7 4 7 5 7 9 7 10
4 6 8 2 4 2 5 2 9 2 10 7 4 7 5 7 9 7 10
8 6 2 7 4 7 5
1 8 2 2 9 2 10
8 2 3 0 14 1 14 2 14 2 4 2 5
0 0 0 0 0 0 0 0 0 0 0 1 1 1 0
0 1 1 1 0 0 0 0 6 0 0 1 9 1 0
0 1 1 1 1 1 1 1 1 0 0 1 1 1 0
0 1 1 1 0 0 1 1 1 0 0 0 1 0 0
0 2 2 2 0 0 5 1 1 0 0 0 2 0 0
0 0 2 0 0 0 1 1 1 0 0 2 2 2 0
0 0 1 0 0 0 1 1 1 0 0 1 1 1 0
1 1 1 1 0 0 1 5 1 1 1 1 1 1 0
1 1 7 1 0 0 6 0 0 0 0 1 1 1 0
1 1 1 1 0 0 0 0 0 0 0 0 0 0 0
