10 15 1 1 3
3 13 0 9 6 9 9
5 12 1 9 6
5 13 1 9 9
1 1 1 0 0 0 0 1 1 1 1 1 1 1 1
1 1 1 1 1 1 1 1 1 1 1 0 0 1 1
1 1 1 0 0 0 0 1 1 0 0 0 0 1 1
0 0 0 0 0 0 0 0 0 0 0 0 1 7 1
0 0 0 0 0 0 0 0 0 0 0 0 1 1 0
1 1 1 0 0 2 2 2 2 1 0 0 5 5 0
1 9 1 2 2 2 2 2 2 2 0 0 1 1 1
1 1 1 2 2 2 2 2 2 2 2 2 1 1 1
0 0 0 0 0 2 2 2 2 2 2 2 1 1 1
0 0 0 0 0 0 1 1 1 1 0 0 0 0 0
