9 14 6 10 3
2 11 2 8 2 8 3
0 13 4 7 2 7 3 1 4 1 5
7 5 2 2 4 2 5
0 0 0 0 0 0 0 0 0 0 0 0 1 6
0 0 1 1 1 1 1 1 0 0 0 1 1 1
0 1 1 1 0 0 1 1 0 0 1 6 1 1
0 1 9 1 0 0 0 1 1 1 1 1 0 0
0 1 1 1 0 0 0 0 1 1 1 0 0 0
0 0 0 0 0 0 0 0 0 1 1 0 0 0
0 0 0 0 1 1 1 0 0 1 1 0 0 0
1 1 0 0 1 6 1 0 0 1 1 0 0 0
1 1 0 0 1 1 1 1 1 1 1 0 0 0
