6 15 4 1 2
2 2 2 4 4 4 5
1 8 2 4 10 4 11
0 0 0 0 0 0 1 1 1 1 0 0 1 1 1
1 1 1 1 0 0 1 1 6 1 0 0 1 9 1
1 1 3 1 0 0 1 1 1 1 0 0 1 1 1
1 1 1 1 0 0 1 1 1 1 0 0 1 1 1
1 1 1 1 0 0 1 1 1 1 0 0 1 1 1
1 1 1 1 0 0 1 1 1 1 0 0 0 0 0