10 13 6 2 2
2 6 1 2 12
0 12 1 4 6
0 0 0 0 0 0 0 0 0 0 0 0 6
0 0 0 0 0 1 1 1 0 0 1 1 1
0 0 0 0 0 1 6 1 1 1 1 1 0
0 0 0 1 1 1 1 1 0 0 1 1 0
0 0 0 1 9 1 0 0 0 0 1 1 0
0 1 1 1 1 1 0 0 0 1 1 1 1
1 1 1 1 0 0 0 0 0 1 1 1 1
1 1 1 1 0 0 1 1 1 1 1 0 0
0 0 0 0 0 1 1 1 0 0 0 0 0
0 0 0 0 0 1 1 1 0 0 0 0 0
