5 15 1 1 1
1 13 2 1 2 1 12
1 1 1 1 0 0 0 1 0 0 0 1 1 1 1
1 1 1 1 0 0 0 1 0 0 0 1 1 8 1
1 1 1 1 1 1 1 1 1 1 1 1 1 1 1
0 0 0 0 0 0 1 9 1 0 0 0 0 0 0
0 0 0 0 0 0 1 1 1 0 0 0 0 0 0
