START -- 3 1 3 1 STANDING 0
========= CURRENT MAP =========

            1 1 1 1 1 1 1     
1 1 1 1     1 1 1     1 1     
1 1 1 1 1 1 1 1 1     1 1 1 1 
1 * 1 1               1 1 9 1 
1 1 1 1               1 1 1 1 
                        1 1 1 

===============================
RIGHT -- 3 2 3 3 LYING_ROW 0
========= CURRENT MAP =========

            1 1 1 1 1 1 1     
1 1 1 1     1 1 1     1 1     
1 1 1 1 1 1 1 1 1     1 1 1 1 
1 1 * *               1 1 9 1 
1 1 1 1               1 1 1 1 
                        1 1 1 

===============================
UP -- 2 2 2 3 LYING_ROW 0
========= CURRENT MAP =========

            1 1 1 1 1 1 1     
1 1 1 1     1 1 1     1 1     
1 1 * * 1 1 1 1 1     1 1 1 1 
1 1 1 1               1 1 9 1 
1 1 1 1               1 1 1 1 
                        1 1 1 

===============================
RIGHT -- 2 4 2 4 STANDING 0
========= CURRENT MAP =========

            1 1 1 1 1 1 1     
1 1 1 1     1 1 1     1 1     
1 1 1 1 * 1 1 1 1     1 1 1 1 
1 1 1 1               1 1 9 1 
1 1 1 1               1 1 1 1 
                        1 1 1 

===============================
RIGHT -- 2 5 2 6 LYING_ROW 0
========= CURRENT MAP =========

            1 1 1 1 1 1 1     
1 1 1 1     1 1 1     1 1     
1 1 1 1 1 * * 1 1     1 1 1 1 
1 1 1 1               1 1 9 1 
1 1 1 1               1 1 1 1 
                        1 1 1 

===============================
RIGHT -- 2 7 2 7 STANDING 0
========= CURRENT MAP =========

            1 1 1 1 1 1 1     
1 1 1 1     1 1 1     1 1     
1 1 1 1 1 1 1 * 1     1 1 1 1 
1 1 1 1               1 1 9 1 
1 1 1 1               1 1 1 1 
                        1 1 1 

===============================
UP -- 0 7 1 7 LYING_COL 0
========= CURRENT MAP =========

            1 * 1 1 1 1 1     
1 1 1 1     1 * 1     1 1     
1 1 1 1 1 1 1 1 1     1 1 1 1 
1 1 1 1               1 1 9 1 
1 1 1 1               1 1 1 1 
                        1 1 1 

===============================
LEFT -- 0 6 1 6 LYING_COL 0
========= CURRENT MAP =========

            * 1 1 1 1 1 1     
1 1 1 1     * 1 1     1 1     
1 1 1 1 1 1 1 1 1     1 1 1 1 
1 1 1 1               1 1 9 1 
1 1 1 1               1 1 1 1 
                        1 1 1 

===============================
DOWN -- 2 6 2 6 STANDING 0
========= CURRENT MAP =========

            1 1 1 1 1 1 1     
1 1 1 1     1 1 1     1 1     
1 1 1 1 1 1 * 1 1     1 1 1 1 
1 1 1 1               1 1 9 1 
1 1 1 1               1 1 1 1 
                        1 1 1 

===============================
RIGHT -- 2 7 2 8 LYING_ROW 0
========= CURRENT MAP =========

            1 1 1 1 1 1 1     
1 1 1 1     1 1 1     1 1     
1 1 1 1 1 1 1 * *     1 1 1 1 
1 1 1 1               1 1 9 1 
1 1 1 1               1 1 1 1 
                        1 1 1 

===============================
UP -- 1 7 1 8 LYING_ROW 0
========= CURRENT MAP =========

            1 1 1 1 1 1 1     
1 1 1 1     1 * *     1 1     
1 1 1 1 1 1 1 1 1     1 1 1 1 
1 1 1 1               1 1 9 1 
1 1 1 1               1 1 1 1 
                        1 1 1 

===============================
UP -- 0 7 0 8 LYING_ROW 0
========= CURRENT MAP =========

            1 * * 1 1 1 1     
1 1 1 1     1 1 1     1 1     
1 1 1 1 1 1 1 1 1     1 1 1 1 
1 1 1 1               1 1 9 1 
1 1 1 1               1 1 1 1 
                        1 1 1 

===============================
RIGHT -- 0 9 0 9 STANDING 0
========= CURRENT MAP =========

            1 1 1 * 1 1 1     
1 1 1 1     1 1 1     1 1     
1 1 1 1 1 1 1 1 1     1 1 1 1 
1 1 1 1               1 1 9 1 
1 1 1 1               1 1 1 1 
                        1 1 1 

===============================
RIGHT -- 0 10 0 11 LYING_ROW 0
========= CURRENT MAP =========

            1 1 1 1 * * 1     
1 1 1 1     1 1 1     1 1     
1 1 1 1 1 1 1 1 1     1 1 1 1 
1 1 1 1               1 1 9 1 
1 1 1 1               1 1 1 1 
                        1 1 1 

===============================
RIGHT -- 0 12 0 12 STANDING 0
========= CURRENT MAP =========

            1 1 1 1 1 1 *     
1 1 1 1     1 1 1     1 1     
1 1 1 1 1 1 1 1 1     1 1 1 1 
1 1 1 1               1 1 9 1 
1 1 1 1               1 1 1 1 
                        1 1 1 

===============================
DOWN -- 1 12 2 12 LYING_COL 0
========= CURRENT MAP =========

            1 1 1 1 1 1 1     
1 1 1 1     1 1 1     1 *     
1 1 1 1 1 1 1 1 1     1 * 1 1 
1 1 1 1               1 1 9 1 
1 1 1 1               1 1 1 1 
                        1 1 1 

===============================
DOWN -- 3 12 3 12 STANDING 0
========= CURRENT MAP =========

            1 1 1 1 1 1 1     
1 1 1 1     1 1 1     1 1     
1 1 1 1 1 1 1 1 1     1 1 1 1 
1 1 1 1               1 * 9 1 
1 1 1 1               1 1 1 1 
                        1 1 1 

===============================
DOWN -- 4 12 5 12 LYING_COL 0
========= CURRENT MAP =========

            1 1 1 1 1 1 1     
1 1 1 1     1 1 1     1 1     
1 1 1 1 1 1 1 1 1     1 1 1 1 
1 1 1 1               1 1 9 1 
1 1 1 1               1 * 1 1 
                        * 1 1 

===============================
RIGHT -- 4 13 5 13 LYING_COL 0
========= CURRENT MAP =========

            1 1 1 1 1 1 1     
1 1 1 1     1 1 1     1 1     
1 1 1 1 1 1 1 1 1     1 1 1 1 
1 1 1 1               1 1 9 1 
1 1 1 1               1 1 * 1 
                        1 * 1 

===============================
UP -- 3 13 3 13 STANDING 0
========= CURRENT MAP =========

            1 1 1 1 1 1 1     
1 1 1 1     1 1 1     1 1     
1 1 1 1 1 1 1 1 1     1 1 1 1 
1 1 1 1               1 1 * 1 
1 1 1 1               1 1 1 1 
                        1 1 1 

===============================

=========== STAT 03 ============
STATUS: SUCCESS
PROCESS TIME: 0:00:00.032731
PROCESS MEMORY: 458752
REAL STEP: 20
VIRTUAL STEP: 861
===============================

PRESS KEY: RURRRULDRUURRRDDDRU

