START -- 4 1 4 1 STANDING 0
========= CURRENT MAP =========

            1 1 1 1     1 1 1 
1 1 1 1     1 1 6 1     1 9 1 
1 1 3 1     1 1 1 1     1 1 1 
1 1 1 1     1 1 1 1     1 1 1 
1 * 1 1     1 1 1 1     1 1 1 
1 1 1 1     1 1 1 1           

===============================
UP -- 2 1 3 1 LYING_COL 0
========= CURRENT MAP =========

            1 1 1 1     1 1 1 
1 1 1 1     1 1 6 1     1 9 1 
1 * 3 1     1 1 1 1     1 1 1 
1 * 1 1     1 1 1 1     1 1 1 
1 1 1 1     1 1 1 1     1 1 1 
1 1 1 1     1 1 1 1           

===============================
RIGHT -- 2 2 3 2 LYING_COL 0
========= CURRENT MAP =========

            1 1 1 1     1 1 1 
1 1 1 1     1 1 6 1     1 9 1 
1 1 * 1     1 1 1 1     1 1 1 
1 1 * 1     1 1 1 1     1 1 1 
1 1 1 1 1 1 1 1 1 1     1 1 1 
1 1 1 1     1 1 1 1           

===============================
DOWN -- 4 2 4 2 STANDING 0
========= CURRENT MAP =========

            1 1 1 1     1 1 1 
1 1 1 1     1 1 6 1     1 9 1 
1 1 3 1     1 1 1 1     1 1 1 
1 1 1 1     1 1 1 1     1 1 1 
1 1 * 1 1 1 1 1 1 1     1 1 1 
1 1 1 1     1 1 1 1           

===============================
RIGHT -- 4 3 4 4 LYING_ROW 0
========= CURRENT MAP =========

            1 1 1 1     1 1 1 
1 1 1 1     1 1 6 1     1 9 1 
1 1 3 1     1 1 1 1     1 1 1 
1 1 1 1     1 1 1 1     1 1 1 
1 1 1 * * 1 1 1 1 1     1 1 1 
1 1 1 1     1 1 1 1           

===============================
RIGHT -- 4 5 4 5 STANDING 0
========= CURRENT MAP =========

            1 1 1 1     1 1 1 
1 1 1 1     1 1 6 1     1 9 1 
1 1 3 1     1 1 1 1     1 1 1 
1 1 1 1     1 1 1 1     1 1 1 
1 1 1 1 1 * 1 1 1 1     1 1 1 
1 1 1 1     1 1 1 1           

===============================
RIGHT -- 4 6 4 7 LYING_ROW 0
========= CURRENT MAP =========

            1 1 1 1     1 1 1 
1 1 1 1     1 1 6 1     1 9 1 
1 1 3 1     1 1 1 1     1 1 1 
1 1 1 1     1 1 1 1     1 1 1 
1 1 1 1 1 1 * * 1 1     1 1 1 
1 1 1 1     1 1 1 1           

===============================
RIGHT -- 4 8 4 8 STANDING 0
========= CURRENT MAP =========

            1 1 1 1     1 1 1 
1 1 1 1     1 1 6 1     1 9 1 
1 1 3 1     1 1 1 1     1 1 1 
1 1 1 1     1 1 1 1     1 1 1 
1 1 1 1 1 1 1 1 * 1     1 1 1 
1 1 1 1     1 1 1 1           

===============================
UP -- 2 8 3 8 LYING_COL 0
========= CURRENT MAP =========

            1 1 1 1     1 1 1 
1 1 1 1     1 1 6 1     1 9 1 
1 1 3 1     1 1 * 1     1 1 1 
1 1 1 1     1 1 * 1     1 1 1 
1 1 1 1 1 1 1 1 1 1     1 1 1 
1 1 1 1     1 1 1 1           

===============================
UP -- 1 8 1 8 STANDING 0
========= CURRENT MAP =========

            1 1 1 1     1 1 1 
1 1 1 1     1 1 * 1     1 9 1 
1 1 3 1     1 1 1 1     1 1 1 
1 1 1 1     1 1 1 1     1 1 1 
1 1 1 1 1 1 1 1 1 1 1 1 1 1 1 
1 1 1 1     1 1 1 1           

===============================
DOWN -- 2 8 3 8 LYING_COL 0
========= CURRENT MAP =========

            1 1 1 1     1 1 1 
1 1 1 1     1 1 6 1     1 9 1 
1 1 3 1     1 1 * 1     1 1 1 
1 1 1 1     1 1 * 1     1 1 1 
1 1 1 1 1 1 1 1 1 1 1 1 1 1 1 
1 1 1 1     1 1 1 1           

===============================
RIGHT -- 2 9 3 9 LYING_COL 0
========= CURRENT MAP =========

            1 1 1 1     1 1 1 
1 1 1 1     1 1 6 1     1 9 1 
1 1 3 1     1 1 1 *     1 1 1 
1 1 1 1     1 1 1 *     1 1 1 
1 1 1 1 1 1 1 1 1 1 1 1 1 1 1 
1 1 1 1     1 1 1 1           

===============================
DOWN -- 4 9 4 9 STANDING 0
========= CURRENT MAP =========

            1 1 1 1     1 1 1 
1 1 1 1     1 1 6 1     1 9 1 
1 1 3 1     1 1 1 1     1 1 1 
1 1 1 1     1 1 1 1     1 1 1 
1 1 1 1 1 1 1 1 1 * 1 1 1 1 1 
1 1 1 1     1 1 1 1           

===============================
RIGHT -- 4 10 4 11 LYING_ROW 0
========= CURRENT MAP =========

            1 1 1 1     1 1 1 
1 1 1 1     1 1 6 1     1 9 1 
1 1 3 1     1 1 1 1     1 1 1 
1 1 1 1     1 1 1 1     1 1 1 
1 1 1 1 1 1 1 1 1 1 * * 1 1 1 
1 1 1 1     1 1 1 1           

===============================
RIGHT -- 4 12 4 12 STANDING 0
========= CURRENT MAP =========

            1 1 1 1     1 1 1 
1 1 1 1     1 1 6 1     1 9 1 
1 1 3 1     1 1 1 1     1 1 1 
1 1 1 1     1 1 1 1     1 1 1 
1 1 1 1 1 1 1 1 1 1 1 1 * 1 1 
1 1 1 1     1 1 1 1           

===============================
UP -- 2 12 3 12 LYING_COL 0
========= CURRENT MAP =========

            1 1 1 1     1 1 1 
1 1 1 1     1 1 6 1     1 9 1 
1 1 3 1     1 1 1 1     * 1 1 
1 1 1 1     1 1 1 1     * 1 1 
1 1 1 1 1 1 1 1 1 1 1 1 1 1 1 
1 1 1 1     1 1 1 1           

===============================
RIGHT -- 2 13 3 13 LYING_COL 0
========= CURRENT MAP =========

            1 1 1 1     1 1 1 
1 1 1 1     1 1 6 1     1 9 1 
1 1 3 1     1 1 1 1     1 * 1 
1 1 1 1     1 1 1 1     1 * 1 
1 1 1 1 1 1 1 1 1 1 1 1 1 1 1 
1 1 1 1     1 1 1 1           

===============================
UP -- 1 13 1 13 STANDING 0
========= CURRENT MAP =========

            1 1 1 1     1 1 1 
1 1 1 1     1 1 6 1     1 * 1 
1 1 3 1     1 1 1 1     1 1 1 
1 1 1 1     1 1 1 1     1 1 1 
1 1 1 1 1 1 1 1 1 1 1 1 1 1 1 
1 1 1 1     1 1 1 1           

===============================

=========== STAT 02 ============
STATUS: SUCCESS
PROCESS TIME: 0:00:00.110156
PROCESS MEMORY: 1146880
REAL STEP: 18
VIRTUAL STEP: 2309
===============================

PRESS KEY: URDRRRRUUDRDRRURU

