START -- 1 1 1 1 STANDING 0
========= CURRENT MAP =========

1 1 1               
1 * 1 1 1 1         
1 1 1 1 1 1 1 1 1   
  1 1 1 1 1 1 1 1 1 
          1 1 9 1 1 
            1 1 1   

===============================
DOWN -- 2 1 3 1 LYING_COL 0
========= CURRENT MAP =========

1 1 1               
1 1 1 1 1 1         
1 * 1 1 1 1 1 1 1   
  * 1 1 1 1 1 1 1 1 
          1 1 9 1 1 
            1 1 1   

===============================
RIGHT -- 2 2 3 2 LYING_COL 0
========= CURRENT MAP =========

1 1 1               
1 1 1 1 1 1         
1 1 * 1 1 1 1 1 1   
  1 * 1 1 1 1 1 1 1 
          1 1 9 1 1 
            1 1 1   

===============================
UP -- 1 2 1 2 STANDING 0
========= CURRENT MAP =========

1 1 1               
1 1 * 1 1 1         
1 1 1 1 1 1 1 1 1   
  1 1 1 1 1 1 1 1 1 
          1 1 9 1 1 
            1 1 1   

===============================
RIGHT -- 1 3 1 4 LYING_ROW 0
========= CURRENT MAP =========

1 1 1               
1 1 1 * * 1         
1 1 1 1 1 1 1 1 1   
  1 1 1 1 1 1 1 1 1 
          1 1 9 1 1 
            1 1 1   

===============================
DOWN -- 2 3 2 4 LYING_ROW 0
========= CURRENT MAP =========

1 1 1               
1 1 1 1 1 1         
1 1 1 * * 1 1 1 1   
  1 1 1 1 1 1 1 1 1 
          1 1 9 1 1 
            1 1 1   

===============================
DOWN -- 3 3 3 4 LYING_ROW 0
========= CURRENT MAP =========

1 1 1               
1 1 1 1 1 1         
1 1 1 1 1 1 1 1 1   
  1 1 * * 1 1 1 1 1 
          1 1 9 1 1 
            1 1 1   

===============================
RIGHT -- 3 5 3 5 STANDING 0
========= CURRENT MAP =========

1 1 1               
1 1 1 1 1 1         
1 1 1 1 1 1 1 1 1   
  1 1 1 1 * 1 1 1 1 
          1 1 9 1 1 
            1 1 1   

===============================
UP -- 1 5 2 5 LYING_COL 0
========= CURRENT MAP =========

1 1 1               
1 1 1 1 1 *         
1 1 1 1 1 * 1 1 1   
  1 1 1 1 1 1 1 1 1 
          1 1 9 1 1 
            1 1 1   

===============================
LEFT -- 1 4 2 4 LYING_COL 0
========= CURRENT MAP =========

1 1 1               
1 1 1 1 * 1         
1 1 1 1 * 1 1 1 1   
  1 1 1 1 1 1 1 1 1 
          1 1 9 1 1 
            1 1 1   

===============================
DOWN -- 3 4 3 4 STANDING 0
========= CURRENT MAP =========

1 1 1               
1 1 1 1 1 1         
1 1 1 1 1 1 1 1 1   
  1 1 1 * 1 1 1 1 1 
          1 1 9 1 1 
            1 1 1   

===============================
RIGHT -- 3 5 3 6 LYING_ROW 0
========= CURRENT MAP =========

1 1 1               
1 1 1 1 1 1         
1 1 1 1 1 1 1 1 1   
  1 1 1 1 * * 1 1 1 
          1 1 9 1 1 
            1 1 1   

===============================
DOWN -- 4 5 4 6 LYING_ROW 0
========= CURRENT MAP =========

1 1 1               
1 1 1 1 1 1         
1 1 1 1 1 1 1 1 1   
  1 1 1 1 1 1 1 1 1 
          * * 9 1 1 
            1 1 1   

===============================
RIGHT -- 4 7 4 7 STANDING 0
========= CURRENT MAP =========

1 1 1               
1 1 1 1 1 1         
1 1 1 1 1 1 1 1 1   
  1 1 1 1 1 1 1 1 1 
          1 1 * 1 1 
            1 1 1   

===============================

=========== STAT 01 ============
STATUS: SUCCESS
PROCESS TIME: 0:00:00.001623
PROCESS MEMORY: 49152
REAL STEP: 14
VIRTUAL STEP: 53
===============================

PRESS KEY: DRURDDRULDRDR

