START -- 1 1 1 1 STANDING 0
========= CURRENT MAP =========

1 1 1 1       1       1 1 1 1 
1 * 1 1       1       1 1 8 1 
1 1 1 1 1 1 1 1 1 1 1 1 1 1 1 
            1 9 1             
            1 1 1             

===============================
RIGHT -- 1 2 1 3 LYING_ROW 0
========= CURRENT MAP =========

1 1 1 1       1       1 1 1 1 
1 1 * *       1       1 1 8 1 
1 1 1 1 1 1 1 1 1 1 1 1 1 1 1 
            1 9 1             
            1 1 1             

===============================
DOWN -- 2 2 2 3 LYING_ROW 0
========= CURRENT MAP =========

1 1 1 1       1       1 1 1 1 
1 1 1 1       1       1 1 8 1 
1 1 * * 1 1 1 1 1 1 1 1 1 1 1 
            1 9 1             
            1 1 1             

===============================
RIGHT -- 2 4 2 4 STANDING 0
========= CURRENT MAP =========

1 1 1 1       1       1 1 1 1 
1 1 1 1       1       1 1 8 1 
1 1 1 1 * 1 1 1 1 1 1 1 1 1 1 
            1 9 1             
            1 1 1             

===============================
RIGHT -- 2 5 2 6 LYING_ROW 0
========= CURRENT MAP =========

1 1 1 1       1       1 1 1 1 
1 1 1 1       1       1 1 8 1 
1 1 1 1 1 * * 1 1 1 1 1 1 1 1 
            1 9 1             
            1 1 1             

===============================
RIGHT -- 2 7 2 7 STANDING 0
========= CURRENT MAP =========

1 1 1 1       1       1 1 1 1 
1 1 1 1       1       1 1 8 1 
1 1 1 1 1 1 1 * 1 1 1 1 1 1 1 
            1 9 1             
            1 1 1             

===============================
RIGHT -- 2 8 2 9 LYING_ROW 0
========= CURRENT MAP =========

1 1 1 1       1       1 1 1 1 
1 1 1 1       1       1 1 8 1 
1 1 1 1 1 1 1 1 * * 1 1 1 1 1 
            1 9 1             
            1 1 1             

===============================
RIGHT -- 2 10 2 10 STANDING 0
========= CURRENT MAP =========

1 1 1 1       1       1 1 1 1 
1 1 1 1       1       1 1 8 1 
1 1 1 1 1 1 1 1 1 1 * 1 1 1 1 
            1 9 1             
            1 1 1             

===============================
RIGHT -- 2 11 2 12 LYING_ROW 0
========= CURRENT MAP =========

1 1 1 1       1       1 1 1 1 
1 1 1 1       1       1 1 8 1 
1 1 1 1 1 1 1 1 1 1 1 * * 1 1 
            1 9 1             
            1 1 1             

===============================
UP -- 1 11 1 12 LYING_ROW 0
========= CURRENT MAP =========

1 1 1 1       1       1 1 1 1 
1 1 1 1       1       * * 8 1 
1 1 1 1 1 1 1 1 1 1 1 1 1 1 1 
            1 9 1             
            1 1 1             

===============================
RIGHT, WAIT -- 1 2 1 12 SPLIT 2
========= CURRENT MAP =========

1 1 1 1       1       1 1 1 1 
1 1 * 1       1       1 * 8 1 
1 1 1 1 1 1 1 1 1 1 1 1 1 1 1 
            1 9 1             
            1 1 1             

===============================
LEFT -- 1 2 1 11 SPLIT 2
========= CURRENT MAP =========

1 1 1 1       1       1 1 1 1 
1 1 * 1       1       * 1 8 1 
1 1 1 1 1 1 1 1 1 1 1 1 1 1 1 
            1 9 1             
            1 1 1             

===============================
SPACE, RIGHT -- 1 3 1 11 SPLIT 1
========= CURRENT MAP =========

1 1 1 1       1       1 1 1 1 
1 1 1 *       1       * 1 8 1 
1 1 1 1 1 1 1 1 1 1 1 1 1 1 1 
            1 9 1             
            1 1 1             

===============================
SPACE, DOWN -- 1 3 2 11 SPLIT 2
========= CURRENT MAP =========

1 1 1 1       1       1 1 1 1 
1 1 1 *       1       1 1 8 1 
1 1 1 1 1 1 1 1 1 1 1 * 1 1 1 
            1 9 1             
            1 1 1             

===============================
LEFT -- 1 3 2 10 SPLIT 2
========= CURRENT MAP =========

1 1 1 1       1       1 1 1 1 
1 1 1 *       1       1 1 8 1 
1 1 1 1 1 1 1 1 1 1 * 1 1 1 1 
            1 9 1             
            1 1 1             

===============================
LEFT -- 1 3 2 9 SPLIT 2
========= CURRENT MAP =========

1 1 1 1       1       1 1 1 1 
1 1 1 *       1       1 1 8 1 
1 1 1 1 1 1 1 1 1 * 1 1 1 1 1 
            1 9 1             
            1 1 1             

===============================
LEFT -- 1 3 2 8 SPLIT 2
========= CURRENT MAP =========

1 1 1 1       1       1 1 1 1 
1 1 1 *       1       1 1 8 1 
1 1 1 1 1 1 1 1 * 1 1 1 1 1 1 
            1 9 1             
            1 1 1             

===============================
SPACE, DOWN -- 2 3 2 8 SPLIT 1
========= CURRENT MAP =========

1 1 1 1       1       1 1 1 1 
1 1 1 1       1       1 1 8 1 
1 1 1 * 1 1 1 1 * 1 1 1 1 1 1 
            1 9 1             
            1 1 1             

===============================
RIGHT -- 2 4 2 8 SPLIT 1
========= CURRENT MAP =========

1 1 1 1       1       1 1 1 1 
1 1 1 1       1       1 1 8 1 
1 1 1 1 * 1 1 1 * 1 1 1 1 1 1 
            1 9 1             
            1 1 1             

===============================
RIGHT -- 2 5 2 8 SPLIT 1
========= CURRENT MAP =========

1 1 1 1       1       1 1 1 1 
1 1 1 1       1       1 1 8 1 
1 1 1 1 1 * 1 1 * 1 1 1 1 1 1 
            1 9 1             
            1 1 1             

===============================
SPACE, LEFT -- 2 5 2 7 SPLIT 2
========= CURRENT MAP =========

1 1 1 1       1       1 1 1 1 
1 1 1 1       1       1 1 8 1 
1 1 1 1 1 * 1 * 1 1 1 1 1 1 1 
            1 9 1             
            1 1 1             

===============================
UP -- 2 5 1 7 SPLIT 2
========= CURRENT MAP =========

1 1 1 1       1       1 1 1 1 
1 1 1 1       *       1 1 8 1 
1 1 1 1 1 * 1 1 1 1 1 1 1 1 1 
            1 9 1             
            1 1 1             

===============================
SPACE, RIGHT -- 2 6 1 7 SPLIT 1
========= CURRENT MAP =========

1 1 1 1       1       1 1 1 1 
1 1 1 1       *       1 1 8 1 
1 1 1 1 1 1 * 1 1 1 1 1 1 1 1 
            1 9 1             
            1 1 1             

===============================
RIGHT -- 1 7 2 7 LYING_COL 1
========= CURRENT MAP =========

1 1 1 1       1       1 1 1 1 
1 1 1 1       *       1 1 8 1 
1 1 1 1 1 1 1 * 1 1 1 1 1 1 1 
            1 9 1             
            1 1 1             

===============================
DOWN -- 3 7 3 7 STANDING 0
========= CURRENT MAP =========

1 1 1 1       1       1 1 1 1 
1 1 1 1       1       1 1 8 1 
1 1 1 1 1 1 1 1 1 1 1 1 1 1 1 
            1 * 1             
            1 1 1             

===============================

=========== STAT 09 ============
STATUS: SUCCESS
PROCESS TIME: 0:00:00.021092
PROCESS MEMORY: 376832
REAL STEP: 25
VIRTUAL STEP: 641
===============================

PRESS KEY: RDRRRRRRURwL-R-DLLL-DRR-LU-RRD

