START -- 4 1 4 1 STANDING 0
========= CURRENT MAP =========

            1 1 1 1     1 1 1 
1 1 1 1     1 1 6 1     1 9 1 
1 1 3 1     1 1 1 1     1 1 1 
1 1 1 1     1 1 1 1     1 1 1 
1 * 1 1     1 1 1 1     1 1 1 
1 1 1 1     1 1 1 1           

===============================
RIGHT -- 4 2 4 3 LYING_ROW 0
========= CURRENT MAP =========

            1 1 1 1     1 1 1 
1 1 1 1     1 1 6 1     1 9 1 
1 1 3 1     1 1 1 1     1 1 1 
1 1 1 1     1 1 1 1     1 1 1 
1 1 * *     1 1 1 1     1 1 1 
1 1 1 1     1 1 1 1           

===============================
UP -- 3 2 3 3 LYING_ROW 0
========= CURRENT MAP =========

            1 1 1 1     1 1 1 
1 1 1 1     1 1 6 1     1 9 1 
1 1 3 1     1 1 1 1     1 1 1 
1 1 * *     1 1 1 1     1 1 1 
1 1 1 1     1 1 1 1     1 1 1 
1 1 1 1     1 1 1 1           

===============================
UP -- 2 2 2 3 LYING_ROW 0
========= CURRENT MAP =========

            1 1 1 1     1 1 1 
1 1 1 1     1 1 6 1     1 9 1 
1 1 * *     1 1 1 1     1 1 1 
1 1 1 1     1 1 1 1     1 1 1 
1 1 1 1 1 1 1 1 1 1     1 1 1 
1 1 1 1     1 1 1 1           

===============================
DOWN -- 3 2 3 3 LYING_ROW 0
========= CURRENT MAP =========

            1 1 1 1     1 1 1 
1 1 1 1     1 1 6 1     1 9 1 
1 1 3 1     1 1 1 1     1 1 1 
1 1 * *     1 1 1 1     1 1 1 
1 1 1 1 1 1 1 1 1 1     1 1 1 
1 1 1 1     1 1 1 1           

===============================
DOWN -- 4 2 4 3 LYING_ROW 0
========= CURRENT MAP =========

            1 1 1 1     1 1 1 
1 1 1 1     1 1 6 1     1 9 1 
1 1 3 1     1 1 1 1     1 1 1 
1 1 1 1     1 1 1 1     1 1 1 
1 1 * * 1 1 1 1 1 1     1 1 1 
1 1 1 1     1 1 1 1           

===============================
RIGHT -- 4 4 4 4 STANDING 0
========= CURRENT MAP =========

            1 1 1 1     1 1 1 
1 1 1 1     1 1 6 1     1 9 1 
1 1 3 1     1 1 1 1     1 1 1 
1 1 1 1     1 1 1 1     1 1 1 
1 1 1 1 * 1 1 1 1 1     1 1 1 
1 1 1 1     1 1 1 1           

===============================
RIGHT -- 4 5 4 6 LYING_ROW 0
========= CURRENT MAP =========

            1 1 1 1     1 1 1 
1 1 1 1     1 1 6 1     1 9 1 
1 1 3 1     1 1 1 1     1 1 1 
1 1 1 1     1 1 1 1     1 1 1 
1 1 1 1 1 * * 1 1 1     1 1 1 
1 1 1 1     1 1 1 1           

===============================
RIGHT -- 4 7 4 7 STANDING 0
========= CURRENT MAP =========

            1 1 1 1     1 1 1 
1 1 1 1     1 1 6 1     1 9 1 
1 1 3 1     1 1 1 1     1 1 1 
1 1 1 1     1 1 1 1     1 1 1 
1 1 1 1 1 1 1 * 1 1     1 1 1 
1 1 1 1     1 1 1 1           

===============================
UP -- 2 7 3 7 LYING_COL 0
========= CURRENT MAP =========

            1 1 1 1     1 1 1 
1 1 1 1     1 1 6 1     1 9 1 
1 1 3 1     1 * 1 1     1 1 1 
1 1 1 1     1 * 1 1     1 1 1 
1 1 1 1 1 1 1 1 1 1     1 1 1 
1 1 1 1     1 1 1 1           

===============================
RIGHT -- 2 8 3 8 LYING_COL 0
========= CURRENT MAP =========

            1 1 1 1     1 1 1 
1 1 1 1     1 1 6 1     1 9 1 
1 1 3 1     1 1 * 1     1 1 1 
1 1 1 1     1 1 * 1     1 1 1 
1 1 1 1 1 1 1 1 1 1     1 1 1 
1 1 1 1     1 1 1 1           

===============================
UP -- 1 8 1 8 STANDING 0
========= CURRENT MAP =========

            1 1 1 1     1 1 1 
1 1 1 1     1 1 * 1     1 9 1 
1 1 3 1     1 1 1 1     1 1 1 
1 1 1 1     1 1 1 1     1 1 1 
1 1 1 1 1 1 1 1 1 1 1 1 1 1 1 
1 1 1 1     1 1 1 1           

===============================
DOWN -- 2 8 3 8 LYING_COL 0
========= CURRENT MAP =========

            1 1 1 1     1 1 1 
1 1 1 1     1 1 6 1     1 9 1 
1 1 3 1     1 1 * 1     1 1 1 
1 1 1 1     1 1 * 1     1 1 1 
1 1 1 1 1 1 1 1 1 1 1 1 1 1 1 
1 1 1 1     1 1 1 1           

===============================
RIGHT -- 2 9 3 9 LYING_COL 0
========= CURRENT MAP =========

            1 1 1 1     1 1 1 
1 1 1 1     1 1 6 1     1 9 1 
1 1 3 1     1 1 1 *     1 1 1 
1 1 1 1     1 1 1 *     1 1 1 
1 1 1 1 1 1 1 1 1 1 1 1 1 1 1 
1 1 1 1     1 1 1 1           

===============================
DOWN -- 4 9 4 9 STANDING 0
========= CURRENT MAP =========

            1 1 1 1     1 1 1 
1 1 1 1     1 1 6 1     1 9 1 
1 1 3 1     1 1 1 1     1 1 1 
1 1 1 1     1 1 1 1     1 1 1 
1 1 1 1 1 1 1 1 1 * 1 1 1 1 1 
1 1 1 1     1 1 1 1           

===============================
RIGHT -- 4 10 4 11 LYING_ROW 0
========= CURRENT MAP =========

            1 1 1 1     1 1 1 
1 1 1 1     1 1 6 1     1 9 1 
1 1 3 1     1 1 1 1     1 1 1 
1 1 1 1     1 1 1 1     1 1 1 
1 1 1 1 1 1 1 1 1 1 * * 1 1 1 
1 1 1 1     1 1 1 1           

===============================
RIGHT -- 4 12 4 12 STANDING 0
========= CURRENT MAP =========

            1 1 1 1     1 1 1 
1 1 1 1     1 1 6 1     1 9 1 
1 1 3 1     1 1 1 1     1 1 1 
1 1 1 1     1 1 1 1     1 1 1 
1 1 1 1 1 1 1 1 1 1 1 1 * 1 1 
1 1 1 1     1 1 1 1           

===============================
UP -- 2 12 3 12 LYING_COL 0
========= CURRENT MAP =========

            1 1 1 1     1 1 1 
1 1 1 1     1 1 6 1     1 9 1 
1 1 3 1     1 1 1 1     * 1 1 
1 1 1 1     1 1 1 1     * 1 1 
1 1 1 1 1 1 1 1 1 1 1 1 1 1 1 
1 1 1 1     1 1 1 1           

===============================
RIGHT -- 2 13 3 13 LYING_COL 0
========= CURRENT MAP =========

            1 1 1 1     1 1 1 
1 1 1 1     1 1 6 1     1 9 1 
1 1 3 1     1 1 1 1     1 * 1 
1 1 1 1     1 1 1 1     1 * 1 
1 1 1 1 1 1 1 1 1 1 1 1 1 1 1 
1 1 1 1     1 1 1 1           

===============================
UP -- 1 13 1 13 STANDING 0
========= CURRENT MAP =========

            1 1 1 1     1 1 1 
1 1 1 1     1 1 6 1     1 * 1 
1 1 3 1     1 1 1 1     1 1 1 
1 1 1 1     1 1 1 1     1 1 1 
1 1 1 1 1 1 1 1 1 1 1 1 1 1 1 
1 1 1 1     1 1 1 1           

===============================

=========== STAT 02 ============
STATUS: SUCCESS
PROCESS TIME: 0:00:00.005836
PROCESS MEMORY: 147456
REAL STEP: 20
VIRTUAL STEP: 141
===============================

PRESS KEY: RUUDDRRRURUDRDRRURU

