START -- 1 1 1 1 STANDING 0
========= CURRENT MAP =========

1 1 1               
1 * 1 1 1 1         
1 1 1 1 1 1 1 1 1   
  1 1 1 1 1 1 1 1 1 
          1 1 9 1 1 
            1 1 1   

===============================
RIGHT -- 1 2 1 3 LYING_ROW 0
========= CURRENT MAP =========

1 1 1               
1 1 * * 1 1         
1 1 1 1 1 1 1 1 1   
  1 1 1 1 1 1 1 1 1 
          1 1 9 1 1 
            1 1 1   

===============================
RIGHT -- 1 4 1 4 STANDING 0
========= CURRENT MAP =========

1 1 1               
1 1 1 1 * 1         
1 1 1 1 1 1 1 1 1   
  1 1 1 1 1 1 1 1 1 
          1 1 9 1 1 
            1 1 1   

===============================
DOWN -- 2 4 3 4 LYING_COL 0
========= CURRENT MAP =========

1 1 1               
1 1 1 1 1 1         
1 1 1 1 * 1 1 1 1   
  1 1 1 * 1 1 1 1 1 
          1 1 9 1 1 
            1 1 1   

===============================
RIGHT -- 2 5 3 5 LYING_COL 0
========= CURRENT MAP =========

1 1 1               
1 1 1 1 1 1         
1 1 1 1 1 * 1 1 1   
  1 1 1 1 * 1 1 1 1 
          1 1 9 1 1 
            1 1 1   

===============================
RIGHT -- 2 6 3 6 LYING_COL 0
========= CURRENT MAP =========

1 1 1               
1 1 1 1 1 1         
1 1 1 1 1 1 * 1 1   
  1 1 1 1 1 * 1 1 1 
          1 1 9 1 1 
            1 1 1   

===============================
RIGHT -- 2 7 3 7 LYING_COL 0
========= CURRENT MAP =========

1 1 1               
1 1 1 1 1 1         
1 1 1 1 1 1 1 * 1   
  1 1 1 1 1 1 * 1 1 
          1 1 9 1 1 
            1 1 1   

===============================
DOWN -- 4 7 4 7 STANDING 0
========= CURRENT MAP =========

1 1 1               
1 1 1 1 1 1         
1 1 1 1 1 1 1 1 1   
  1 1 1 1 1 1 1 1 1 
          1 1 * 1 1 
            1 1 1   

===============================

=========== STAT 01 ============
STATUS: SUCCESS
PROCESS TIME: 0:00:00.001203
PROCESS MEMORY: 65536
REAL STEP: 8
VIRTUAL STEP: 37
===============================

PRESS KEY: RRDRRRD

