START -- 4 1 4 1 STANDING 0
========= CURRENT MAP =========

                  1 1 1       
                  1 1 1       
                  1 1 1       
1 1 1 1 1 1       1 1 1 1 1 1 
1 * 1 1 8 1       1 1 1 1 9 1 
1 1 1 1 1 1       1 1 1 1 1 1 
                  1 1 1       
                  1 1 1       
                  1 1 1       

===============================
RIGHT -- 4 2 4 3 LYING_ROW 0
========= CURRENT MAP =========

                  1 1 1       
                  1 1 1       
                  1 1 1       
1 1 1 1 1 1       1 1 1 1 1 1 
1 1 * * 8 1       1 1 1 1 9 1 
1 1 1 1 1 1       1 1 1 1 1 1 
                  1 1 1       
                  1 1 1       
                  1 1 1       

===============================
RIGHT, WAIT -- 1 10 7 10 SPLIT 1
========= CURRENT MAP =========

                  1 1 1       
                  1 * 1       
                  1 1 1       
1 1 1 1 1 1       1 1 1 1 1 1 
1 1 1 1 8 1       1 1 1 1 9 1 
1 1 1 1 1 1       1 1 1 1 1 1 
                  1 1 1       
                  1 * 1       
                  1 1 1       

===============================
SPACE, UP -- 1 10 6 10 SPLIT 2
========= CURRENT MAP =========

                  1 1 1       
                  1 * 1       
                  1 1 1       
1 1 1 1 1 1       1 1 1 1 1 1 
1 1 1 1 8 1       1 1 1 1 9 1 
1 1 1 1 1 1       1 1 1 1 1 1 
                  1 * 1       
                  1 1 1       
                  1 1 1       

===============================
RIGHT -- 1 10 6 11 SPLIT 2
========= CURRENT MAP =========

                  1 1 1       
                  1 * 1       
                  1 1 1       
1 1 1 1 1 1       1 1 1 1 1 1 
1 1 1 1 8 1       1 1 1 1 9 1 
1 1 1 1 1 1       1 1 1 1 1 1 
                  1 1 *       
                  1 1 1       
                  1 1 1       

===============================
SPACE, DOWN -- 2 10 6 11 SPLIT 1
========= CURRENT MAP =========

                  1 1 1       
                  1 1 1       
                  1 * 1       
1 1 1 1 1 1       1 1 1 1 1 1 
1 1 1 1 8 1       1 1 1 1 9 1 
1 1 1 1 1 1       1 1 1 1 1 1 
                  1 1 *       
                  1 1 1       
                  1 1 1       

===============================
RIGHT -- 2 11 6 11 SPLIT 1
========= CURRENT MAP =========

                  1 1 1       
                  1 1 1       
                  1 1 *       
1 1 1 1 1 1       1 1 1 1 1 1 
1 1 1 1 8 1       1 1 1 1 9 1 
1 1 1 1 1 1       1 1 1 1 1 1 
                  1 1 *       
                  1 1 1       
                  1 1 1       

===============================
SPACE, UP -- 2 11 5 11 SPLIT 2
========= CURRENT MAP =========

                  1 1 1       
                  1 1 1       
                  1 1 *       
1 1 1 1 1 1       1 1 1 1 1 1 
1 1 1 1 8 1       1 1 1 1 9 1 
1 1 1 1 1 1       1 1 * 1 1 1 
                  1 1 1       
                  1 1 1       
                  1 1 1       

===============================
RIGHT -- 2 11 5 12 SPLIT 2
========= CURRENT MAP =========

                  1 1 1       
                  1 1 1       
                  1 1 *       
1 1 1 1 1 1       1 1 1 1 1 1 
1 1 1 1 8 1       1 1 1 1 9 1 
1 1 1 1 1 1       1 1 1 * 1 1 
                  1 1 1       
                  1 1 1       
                  1 1 1       

===============================
SPACE, DOWN -- 3 11 5 12 SPLIT 1
========= CURRENT MAP =========

                  1 1 1       
                  1 1 1       
                  1 1 1       
1 1 1 1 1 1       1 1 * 1 1 1 
1 1 1 1 8 1       1 1 1 1 9 1 
1 1 1 1 1 1       1 1 1 * 1 1 
                  1 1 1       
                  1 1 1       
                  1 1 1       

===============================
SPACE, UP -- 3 11 4 12 SPLIT 2
========= CURRENT MAP =========

                  1 1 1       
                  1 1 1       
                  1 1 1       
1 1 1 1 1 1       1 1 * 1 1 1 
1 1 1 1 8 1       1 1 1 * 9 1 
1 1 1 1 1 1       1 1 1 1 1 1 
                  1 1 1       
                  1 1 1       
                  1 1 1       

===============================
SPACE, DOWN -- 4 11 4 12 LYING_ROW 1
========= CURRENT MAP =========

                  1 1 1       
                  1 1 1       
                  1 1 1       
1 1 1 1 1 1       1 1 1 1 1 1 
1 1 1 1 8 1       1 1 * * 9 1 
1 1 1 1 1 1       1 1 1 1 1 1 
                  1 1 1       
                  1 1 1       
                  1 1 1       

===============================
RIGHT -- 4 13 4 13 STANDING 0
========= CURRENT MAP =========

                  1 1 1       
                  1 1 1       
                  1 1 1       
1 1 1 1 1 1       1 1 1 1 1 1 
1 1 1 1 8 1       1 1 1 1 * 1 
1 1 1 1 1 1       1 1 1 1 1 1 
                  1 1 1       
                  1 1 1       
                  1 1 1       

===============================

=========== STAT 08 ============
STATUS: SUCCESS
PROCESS TIME: 0:00:00.009925
PROCESS MEMORY: 327680
REAL STEP: 13
VIRTUAL STEP: 177
===============================

PRESS KEY: RRw-UR-DR-UR-D-U-DR

