START -- 3 1 3 1 STANDING 0
========= CURRENT MAP =========

            1 1 1 1 1 1 1     
1 1 1 1     1 1 1     1 1     
1 1 1 1 1 1 1 1 1     1 1 1 1 
1 * 1 1               1 1 9 1 
1 1 1 1               1 1 1 1 
                        1 1 1 

===============================
RIGHT -- 3 2 3 3 LYING_ROW 0
========= CURRENT MAP =========

            1 1 1 1 1 1 1     
1 1 1 1     1 1 1     1 1     
1 1 1 1 1 1 1 1 1     1 1 1 1 
1 1 * *               1 1 9 1 
1 1 1 1               1 1 1 1 
                        1 1 1 

===============================
UP -- 2 2 2 3 LYING_ROW 0
========= CURRENT MAP =========

            1 1 1 1 1 1 1     
1 1 1 1     1 1 1     1 1     
1 1 * * 1 1 1 1 1     1 1 1 1 
1 1 1 1               1 1 9 1 
1 1 1 1               1 1 1 1 
                        1 1 1 

===============================
RIGHT -- 2 4 2 4 STANDING 0
========= CURRENT MAP =========

            1 1 1 1 1 1 1     
1 1 1 1     1 1 1     1 1     
1 1 1 1 * 1 1 1 1     1 1 1 1 
1 1 1 1               1 1 9 1 
1 1 1 1               1 1 1 1 
                        1 1 1 

===============================
RIGHT -- 2 5 2 6 LYING_ROW 0
========= CURRENT MAP =========

            1 1 1 1 1 1 1     
1 1 1 1     1 1 1     1 1     
1 1 1 1 1 * * 1 1     1 1 1 1 
1 1 1 1               1 1 9 1 
1 1 1 1               1 1 1 1 
                        1 1 1 

===============================
RIGHT -- 2 7 2 7 STANDING 0
========= CURRENT MAP =========

            1 1 1 1 1 1 1     
1 1 1 1     1 1 1     1 1     
1 1 1 1 1 1 1 * 1     1 1 1 1 
1 1 1 1               1 1 9 1 
1 1 1 1               1 1 1 1 
                        1 1 1 

===============================
UP -- 0 7 1 7 LYING_COL 0
========= CURRENT MAP =========

            1 * 1 1 1 1 1     
1 1 1 1     1 * 1     1 1     
1 1 1 1 1 1 1 1 1     1 1 1 1 
1 1 1 1               1 1 9 1 
1 1 1 1               1 1 1 1 
                        1 1 1 

===============================
RIGHT -- 0 8 1 8 LYING_COL 0
========= CURRENT MAP =========

            1 1 * 1 1 1 1     
1 1 1 1     1 1 *     1 1     
1 1 1 1 1 1 1 1 1     1 1 1 1 
1 1 1 1               1 1 9 1 
1 1 1 1               1 1 1 1 
                        1 1 1 

===============================
DOWN -- 2 8 2 8 STANDING 0
========= CURRENT MAP =========

            1 1 1 1 1 1 1     
1 1 1 1     1 1 1     1 1     
1 1 1 1 1 1 1 1 *     1 1 1 1 
1 1 1 1               1 1 9 1 
1 1 1 1               1 1 1 1 
                        1 1 1 

===============================
LEFT -- 2 6 2 7 LYING_ROW 0
========= CURRENT MAP =========

            1 1 1 1 1 1 1     
1 1 1 1     1 1 1     1 1     
1 1 1 1 1 1 * * 1     1 1 1 1 
1 1 1 1               1 1 9 1 
1 1 1 1               1 1 1 1 
                        1 1 1 

===============================
UP -- 1 6 1 7 LYING_ROW 0
========= CURRENT MAP =========

            1 1 1 1 1 1 1     
1 1 1 1     * * 1     1 1     
1 1 1 1 1 1 1 1 1     1 1 1 1 
1 1 1 1               1 1 9 1 
1 1 1 1               1 1 1 1 
                        1 1 1 

===============================
UP -- 0 6 0 7 LYING_ROW 0
========= CURRENT MAP =========

            * * 1 1 1 1 1     
1 1 1 1     1 1 1     1 1     
1 1 1 1 1 1 1 1 1     1 1 1 1 
1 1 1 1               1 1 9 1 
1 1 1 1               1 1 1 1 
                        1 1 1 

===============================
RIGHT -- 0 8 0 8 STANDING 0
========= CURRENT MAP =========

            1 1 * 1 1 1 1     
1 1 1 1     1 1 1     1 1     
1 1 1 1 1 1 1 1 1     1 1 1 1 
1 1 1 1               1 1 9 1 
1 1 1 1               1 1 1 1 
                        1 1 1 

===============================
RIGHT -- 0 9 0 10 LYING_ROW 0
========= CURRENT MAP =========

            1 1 1 * * 1 1     
1 1 1 1     1 1 1     1 1     
1 1 1 1 1 1 1 1 1     1 1 1 1 
1 1 1 1               1 1 9 1 
1 1 1 1               1 1 1 1 
                        1 1 1 

===============================
RIGHT -- 0 11 0 11 STANDING 0
========= CURRENT MAP =========

            1 1 1 1 1 * 1     
1 1 1 1     1 1 1     1 1     
1 1 1 1 1 1 1 1 1     1 1 1 1 
1 1 1 1               1 1 9 1 
1 1 1 1               1 1 1 1 
                        1 1 1 

===============================
DOWN -- 1 11 2 11 LYING_COL 0
========= CURRENT MAP =========

            1 1 1 1 1 1 1     
1 1 1 1     1 1 1     * 1     
1 1 1 1 1 1 1 1 1     * 1 1 1 
1 1 1 1               1 1 9 1 
1 1 1 1               1 1 1 1 
                        1 1 1 

===============================
RIGHT -- 1 12 2 12 LYING_COL 0
========= CURRENT MAP =========

            1 1 1 1 1 1 1     
1 1 1 1     1 1 1     1 *     
1 1 1 1 1 1 1 1 1     1 * 1 1 
1 1 1 1               1 1 9 1 
1 1 1 1               1 1 1 1 
                        1 1 1 

===============================
DOWN -- 3 12 3 12 STANDING 0
========= CURRENT MAP =========

            1 1 1 1 1 1 1     
1 1 1 1     1 1 1     1 1     
1 1 1 1 1 1 1 1 1     1 1 1 1 
1 1 1 1               1 * 9 1 
1 1 1 1               1 1 1 1 
                        1 1 1 

===============================
DOWN -- 4 12 5 12 LYING_COL 0
========= CURRENT MAP =========

            1 1 1 1 1 1 1     
1 1 1 1     1 1 1     1 1     
1 1 1 1 1 1 1 1 1     1 1 1 1 
1 1 1 1               1 1 9 1 
1 1 1 1               1 * 1 1 
                        * 1 1 

===============================
RIGHT -- 4 13 5 13 LYING_COL 0
========= CURRENT MAP =========

            1 1 1 1 1 1 1     
1 1 1 1     1 1 1     1 1     
1 1 1 1 1 1 1 1 1     1 1 1 1 
1 1 1 1               1 1 9 1 
1 1 1 1               1 1 * 1 
                        1 * 1 

===============================
UP -- 3 13 3 13 STANDING 0
========= CURRENT MAP =========

            1 1 1 1 1 1 1     
1 1 1 1     1 1 1     1 1     
1 1 1 1 1 1 1 1 1     1 1 1 1 
1 1 1 1               1 1 * 1 
1 1 1 1               1 1 1 1 
                        1 1 1 

===============================

=========== STAT 03 ============
STATUS: SUCCESS
PROCESS TIME: 0:00:00.005583
PROCESS MEMORY: 131072
REAL STEP: 21
VIRTUAL STEP: 145
===============================

PRESS KEY: RURRRURDLUURRRDRDDRU

